강진군보건소	보건소	구매
한국기술교육대학교	교육기관	추천
청주시서원보건소	보건소	구매
청주시서원보건소건강증진팀	보건소	구매
이천시보건소	보건소	구매
전북특별자치도 정신건강복지센터	전문기관	구매
횡성군보건소	보건소	추천
국민건강보험공단 김제지사	공공기관(기타)	구매
국민건강보험공단 김제지사 2026년 캠페인 홍보 물품 납품	공공기관(기타)	구매
함평군보건소	보건소	구매
경상북도 구미시 선산읍 선주로 121 선산보건소 건강증진팀 조윤호 T.054-480-4134	보건소	구매
조은요양병원	사업장	구매
김해중독관리통합지원센터	전문기관	만족
진주중독관리통합지원센터	전문기관	구매
삼척시정신건강복지센터	전문기관	추천
파주시중독관리통합지원센터	전문기관	만족
군위군보건소	보건소	구매
광진구보건소	보건소	추천
부산중독관리통합지원센터	전문기관	만족
대구광역시청	공공기관(기타)	구매
통영시보건소	보건소	만족
구미중독관리통합지원센터	전문기관	구매
군포시 산본보건지소	보건소	만족
포항북구보건소	보건소	구매
남양주시 동부보건소	보건소	구매
정선고등학교	교육기관	구매
제주중독관리통합지원센터	전문기관	구매
여수시보건소	보건소	구매
경상남도광역정신건강복지센터	전문기관	만족
충북광역정신건강복지센터	전문기관	구매
대전광역정신건강복지센터	전문기관	구매
창원중독관리통합지원센터	전문기관	추천
강북구보건소	보건소	만족
우산건강생활지원센터	보건소	구매
서울여자대학교 금연 캠페인 프로젝트팀 포장불가	교육기관	구매
성동구보건소	보건소	구매
동해시정신건강복지센터	전문기관	구매
아산시보건소	보건소	구매
국군포천병원 외래간호과	군/경/소방	구매
괴산군보건소	보건소	구매
광문고등학교	교육기관	구매
대전서구중독관리통합지원센터	전문기관	구매
울릉군보건의료원	보건소	만족
제주보건소	보건소	만족
구미건강생활지원센터	보건소	구매
포항보건소	보건소	구매
김포시청	공공기관(기타)	구매
남양주보건소	보건소	만족
무주군보건의료원	보건소	구매
김해시보건소	보건소	구매
국군수도병원	군/경/소방	구매
서초구보건소	보건소	추천
무안군보건소	보건소	구매
중1동행정복지센터	복지기관	구매
부산 기장군보건소	보건소	구매
동대문구보건소	보건소	만족
춘천시보건소	보건소	구매
완산고등학교	교육기관	구매
금산군보건소	보건소	구매
구미시보건소	보건소	구매
상경중학교	교육기관	구매
덕양구보건소	보건소	구매
60사단 의무대	군/경/소방	만족
옹진군보건소	보건소	만족
마포구정신건강복지센터	전문기관	구매
보령시보건소	보건소	구매
도봉중독관리통합지원센터	전문기관	만족
한국보훈복지의료공단 광주보훈병원	공공기관(기타)	구매
대구북구보건소	보건소	구매
서울시통합건강증진사업지원단	광역시도 건강증진부서	구매
약학대학 학부실습 과정에 사용 예정	전공교육	구매
마포구보건소	보건소	추천
국립정신건강센터 정신건강사업과 키트 제작	전문기관	구매
부산가톨릭대학교중독이음센터	전문기관	구매
양천구보건소	보건소	구매
안양범계중학교	교육기관	구매
광주 광산중독관리통합지원센터	전문기관	구매
군산시보건소	보건소	구매
사천시보건소	보건소	구매
대구광역시 중구보건소	보건소	구매
전남여자상업고등학교	교육기관	구매
안성시정신건강복지센터	전문기관	구매
전북대학교 소방공무원 심리지원센터	교육기관	구매
서대문구보건소	보건소	구매
[육군]66보병사단 의무대	군/경/소방	구매
송파구정신건강복지센터	전문기관	만족
한양대학교 학생지원팀 한양보건센터	교육기관	구매
서울중구보건소	보건소	만족
국립부곡병원	군/경/소방	구매
양평군보건소	보건소	구매
대구수성구보건소	보건소	구매
국군양주병원	군/경/소방	만족
경주시보건소	보건소	추천
울주군보건소	보건소	추천
서울금연지원센터	금연지원센터	만족
3사단 의무대	군/경/소방	구매
영동군보건소	보건소	구매
연수구중독관리통합지원센터	전문기관	구매
송파구보건소	보건소	구매
경기도중독관리센터	전문기관	구매
국군강릉병원	군/경/소방	구매
마산중독관리통합지원센터	전문기관	만족
대전세종금연지원센터	금연지원센터	구매
진주시보건소	보건소	구매
육군제2062부대	군/경/소방	구매
춘천시보건소 건강관리과	보건소	만족
한국건강관리협회 울산광역시지부	공공기관(기타)	구매
홍성군보건소	보건소	구매
홍성군보건소	보건소	추천
부안보건소	보건소	구매
설천중·고등학교	교육기관	구매
남해군보건소	보건소	구매
보건소 납품	보건소	구매
예산덕산중학교	교육기관	구매
한국건강관리협회	공공기관(기타)	구매
한국경마축산고등학교	교육기관	구매
달성군보건소	보건소	만족
강남구보건소 금연클리닉	보건소	추천
줄포자동차공업고등학교	교육기관	구매
종로구정신건강복지센터	전문기관	구매
대구한의대학교 보건학부	전공교육	구매
용인 3개구 보건소	보건소	구매
무주중학교	교육기관	구매
카프성모병원	공공기관(기타)	구매
청평고등학교	교육기관	만족
학교 보건수업	교육기관	구매
서산시보건소	보건소	구매
대구한의대학교	전공교육	구매
서울금연	금연지원센터	만족
17사단의무대대	군/경/소방	추천
전주중학교	교육기관	만족
동국대학교사범대학부속고등학교	교육기관	구매
서울교통공사	사업장	구매
한국나노마이스터고등학교	교육기관	구매
아산시보건소 중독관리통합지원센터	전문기관	구매
전주호성중학교	교육기관	구매
유성구중독관리통합지원센터	전문기관	구매
사업장 건강증진프로그램	사업장	구매
판촉사랑->국군강릉병원으로 납품	사업장	구매
성남시중독관리통합지원센터	전문기관	구매
광주광역시 서구보건소	보건소	구매
아산시중독관리통합지원센터	전문기관	구매
온누리안과병원	사업장	구매
GC녹십자 건강관리실	사업장	구매
순천향대학교	전공교육	구매
고등학교 동아리 행사	교육기관	구매
창원시중독관리통합지원센터	전문기관	만족
경북기계공업고등학교	교육기관	구매
김포시정신건강복지센터 부설 중독관리통합지원센터	전문기관	구매
바이플러스,김제시보건소	보건소	구매
춘성중학교	교육기관	구매
무안군보건소	보건소	구매
인천동구중독관리통합지원센터	전문기관	구매
광주북구중독관리통합지원센터	전문기관	구매
동두천정신건강복지센터	전문기관	구매
청양정산중학교	교육기관	구매
금산군보건소	보건소	구매
육군사관학교 의무대대	군/경/소방	구매
국민건강의료기	사업장	구매
진주보건소, 맥선	보건소	구매
국군춘천병원	군/경/소방	구매
국군서울지구병원	군/경/소방	구매
대구남구보건소	보건소	구매
기장군보건소	보건소	구매
남양주동부보건센터	보건소	구매
15사단 의무대대	군/경/소방	구매
75사단 의무대	군/경/소방	구매
대구동구중독관리통합지원센터	전문기관	구매
국군강릉병원	군/경/소방	구매
서울시통합건강증진사업단	광역시도 건강증진부서	만족
수성구보건소	보건소	구매
종로구보건소	보건소	구매
동대문구정신건강복지센터	전문기관	구매
동작구정신보건복지센터	전문기관	구매
울산 남구보건소	보건소	만족
예산군보건소	보건소	구매
서울시청	공공기관(기타)	구매
정선군보건소	보건소	구매
영등포구보건소	보건소	구매
경상대예방의학교실	전공교육	구매
경상국립대학교 예방의학교실	전공교육	구매
태백시보건소	보건소	구매
국군구리병원	군/경/소방	구매
예산군보건소	보건소	구매
완도해양경찰서	군/경/소방	구매
용산구보건소	보건소	구매
충남 서산시보건소	보건소	구매
동국대학교사범대학부속중고등학교	교육기관	구매
무풍고등학교	교육기관	구매
달서구보건소	보건소	구매
원주시보건소	보건소	구매
서울시 통합건강증진사업지원단 금연사업팀	공공기관(기타)	구매
영동군보건소	보건소	구매
국민건강보험공단 서귀포지사	공공기관(기타)	구매
영주시보건소	보건소	구매
울산동구정신건강복지센터	전문기관	구매
동작구정신건강복지센터	전문기관	구매
영암군보건소	보건소	구매
강서구정신건강복지센터	전문기관	구매
태평서울병원	사업장	만족
건강생활팀	보건소	구매
충주시보건소	보건소	구매
용산보건소	보건소	구매
광진구정신건강복지센터	전문기관	구매
서초구보건소마음건강센터	보건소	구매
제주광역 정신건강복지센터 중독통합관리팀	전문기관	구매
서울신목초등학교	교육기관	구매
광주남구보건소	보건소	구매
전주시 중독관리통합지원센터	전문기관	구매
육군사관학교 군부대	군/경/소방	구매
한화솔루션 큐셀 음성제2사업장 건강관리실	사업장	구매
한화큐셀 진천사업장 건강관리실	사업장	구매
김포시정신건강복지센터	전문기관	구매
유성여자고등학교	교육기관	구매
함양군보건소	보건소	만족
달서구중독관리통합지원센터	전문기관	구매
2601부대	군/경/소방	구매
화순전남금연지원센터	금연지원센터	구매
이화여대 약학대학	전공교육	구매
5733부대 60사단 의무대	군/경/소방	구매
육군훈련소 지구병원	군/경/소방	구매
영진전문대학	교육기관	구매
강원과학고등학교 보건실	교육기관	구매
부석중학교	교육기관	구매
계명대학교	교육기관	구매
수도방위사령부	군/경/소방	구매
익산시보건소	보건소	구매
김포시보건소	보건소	구매
강동구보건소	보건소	구매
군포시정신건강복지센터	전문기관	구매
전주대학교 의과학대학 행정실	전공교육	구매
강원대병원 강원지역암센터	공공기관(기타)	만족
이화여자대학교	교육기관	구매
목포대학교	교육기관	구매
군산고등학교	교육기관	구매
대구광역정신건강복지센터	전문기관	구매
증평군보건소	보건소	구매
화순전남대학교병원	교육기관	구매
울산중구중독관리통합지원센터	전문기관	구매
오산시보건소	보건소	구매
전주대학교	전공교육	구매
봉화군정신건강복지센터	전문기관	구매
세종특별자치시광역정신건강복지센터	전문기관	구매
김제고등학교 보건실	교육기관	구매
장흥군정신건강복지센터	전문기관	구매
제8기동사단 의무대	군/경/소방	구매
국군홍천병원	군/경/소방	만족
60사단 군사경찰대대	군/경/소방	구매
광주시보건소	보건소	구매
대구달서구보건소	보건소	구매
화천군보건의료원	보건소	구매
성주군보건소	보건소	구매
국립부곡병원 중독진단과	군/경/소방	구매
인천중구보건소	보건소	만족
60사단	군/경/소방	구매
제주서귀포시보건소	보건소	만족
사천시보건소	보건소	구매
국군고양병원	군/경/소방	구매
시흥시보건소	보건소	구매
군산시중독관리통합지원센터	전문기관	구매
옹진군정신건강복지센터	전문기관	구매
대구동부중독관리통합지원센터	전문기관	구매
완주군정신건강복지센터	전문기관	구매
강릉시보건소	보건소	인지
고성군보건소	보건소	인지
동해시보건소	보건소	인지
삼척시보건소	보건소	인지
속초시보건소	보건소	인지
양구군보건소	보건소	인지
양양군보건소	보건소	인지
영월군보건소	보건소	인지
인제군보건소	보건소	인지
철원군보건소	보건소	인지
평창군보건소	보건소	인지
홍천군보건소	보건소	인지
가평군보건소	보건소	인지
과천시보건소	보건소	인지
광명시보건소	보건소	인지
구리시보건소	보건소	인지
동두천시보건소	보건소	인지
부천시보건소	보건소	인지
성남시보건소	보건소	인지
수원시보건소	보건소	인지
안산시보건소	보건소	인지
안성시보건소	보건소	인지
안양시보건소	보건소	인지
양주시보건소	보건소	인지
여주시보건소	보건소	인지
연천군보건소	보건소	인지
의왕시보건소	보건소	인지
의정부시보건소	보건소	인지
파주시보건소	보건소	인지
평택시보건소	보건소	인지
포천시보건소	보건소	인지
하남시보건소	보건소	인지
화성시보건소	보건소	인지
거제시보건소	보건소	인지
거창군보건소	보건소	인지
고성군보건소	보건소	인지
밀양시보건소	보건소	인지
산청군보건소	보건소	인지
양산시보건소	보건소	인지
의령군보건소	보건소	인지
창녕군보건소	보건소	인지
창원시보건소	보건소	인지
하동군보건소	보건소	인지
함안군보건소	보건소	인지
합천군보건소	보건소	인지
경산시보건소	보건소	인지
고령군보건소	보건소	인지
군위군보건소	보건소	인지
김천시보건소	보건소	인지
문경시보건소	보건소	인지
봉화군보건소	보건소	인지
상주시보건소	보건소	인지
영덕군보건소	보건소	인지
영양군보건소	보건소	인지
영천시보건소	보건소	인지
예천군보건소	보건소	인지
울진군보건소	보건소	인지
의성군보건소	보건소	인지
청도군보건소	보건소	인지
청송군보건소	보건소	인지
칠곡군보건소	보건소	인지
동구보건소	보건소	인지
동구보건소	보건소	인지
서구보건소	보건소	인지
대덕구보건소	보건소	인지
동구보건소	보건소	인지
서구보건소	보건소	인지
유성구보건소	보건소	인지
강서구보건소	보건소	인지
금정구보건소	보건소	인지
남구보건소	보건소	인지
동구보건소	보건소	인지
동래구보건소	보건소	인지
부산진구보건소	보건소	인지
북구보건소	보건소	인지
사상구보건소	보건소	인지
사하구보건소	보건소	인지
서구보건소	보건소	인지
수영구보건소	보건소	인지
연제구보건소	보건소	인지
영도구보건소	보건소	인지
중구보건소	보건소	인지
해운대구보건소	보건소	인지
강서구보건소	보건소	인지
관악구보건소	보건소	인지
구로구보건소	보건소	인지
금천구보건소	보건소	인지
노원구보건소	보건소	인지
도봉구보건소	보건소	인지
동작구보건소	보건소	인지
성북구보건소	보건소	인지
은평구보건소	보건소	인지
중랑구보건소	보건소	인지
세종시보건소	보건소	인지
동구보건소	보건소	인지
북구보건소	보건소	인지
중구보건소	보건소	인지
강화군보건소	보건소	인지
계양구보건소	보건소	인지
남동구보건소	보건소	인지
동구보건소	보건소	인지
미추홀구보건소	보건소	인지
부평구보건소	보건소	인지
서구보건소	보건소	인지
연수구보건소	보건소	인지
고흥군보건소	보건소	인지
곡성군보건소	보건소	인지
광양시보건소	보건소	인지
구례군보건소	보건소	인지
나주시보건소	보건소	인지
담양군보건소	보건소	인지
목포시보건소	보건소	인지
보성군보건소	보건소	인지
순천시보건소	보건소	인지
신안군보건소	보건소	인지
영광군보건소	보건소	인지
완도군보건소	보건소	인지
장성군보건소	보건소	인지
장흥군보건소	보건소	인지
진도군보건소	보건소	인지
해남군보건소	보건소	인지
화순군보건소	보건소	인지
고창군보건소	보건소	인지
남원시보건소	보건소	인지
순창군보건소	보건소	인지
완주군보건소	보건소	인지
임실군보건소	보건소	인지
장수군보건소	보건소	인지
전주시보건소	보건소	인지
정읍시보건소	보건소	인지
진안군보건소	보건소	인지
계룡시보건소	보건소	인지
공주시보건소	보건소	인지
논산시보건소	보건소	인지
당진시보건소	보건소	인지
부여군보건소	보건소	인지
서천군보건소	보건소	인지
천안시보건소	보건소	인지
청양군보건소	보건소	인지
태안군보건소	보건소	인지
단양군보건소	보건소	인지
보은군보건소	보건소	인지
옥천군보건소	보건소	인지
음성군보건소	보건소	인지
제천시보건소	보건소	인지
진천군보건소	보건소	인지
강릉시정신건강복지센터	전문기관	인지
고성군정신건강복지센터	전문기관	인지
속초시정신건강복지센터	전문기관	인지
양구군정신건강복지센터	전문기관	인지
양양군정신건강복지센터	전문기관	인지
영월군정신건강복지센터	전문기관	인지
원주시정신건강복지센터	전문기관	인지
인제군정신건강복지센터	전문기관	인지
정선군정신건강복지센터	전문기관	인지
철원군정신건강복지센터	전문기관	인지
춘천시정신건강복지센터	전문기관	인지
태백시정신건강복지센터	전문기관	인지
평창군정신건강복지센터	전문기관	인지
홍천군정신건강복지센터	전문기관	인지
화천군정신건강복지센터	전문기관	인지
횡성군정신건강복지센터	전문기관	인지
가평군정신건강복지센터	전문기관	인지
고양시정신건강복지센터	전문기관	인지
과천시정신건강복지센터	전문기관	인지
광명시정신건강복지센터	전문기관	인지
광주시정신건강복지센터	전문기관	인지
구리시정신건강복지센터	전문기관	인지
남양주시정신건강복지센터	전문기관	인지
부천시정신건강복지센터	전문기관	인지
성남시정신건강복지센터	전문기관	인지
수원시정신건강복지센터	전문기관	인지
시흥시정신건강복지센터	전문기관	인지
안산시정신건강복지센터	전문기관	인지
안양시정신건강복지센터	전문기관	인지
양주시정신건강복지센터	전문기관	인지
양평군정신건강복지센터	전문기관	인지
여주시정신건강복지센터	전문기관	인지
연천군정신건강복지센터	전문기관	인지
오산시정신건강복지센터	전문기관	인지
용인시정신건강복지센터	전문기관	인지
의왕시정신건강복지센터	전문기관	인지
의정부시정신건강복지센터	전문기관	인지
이천시정신건강복지센터	전문기관	인지
파주시정신건강복지센터	전문기관	인지
포천시정신건강복지센터	전문기관	인지
하남시정신건강복지센터	전문기관	인지
화성시정신건강복지센터	전문기관	인지
거제시정신건강복지센터	전문기관	인지
거창군정신건강복지센터	전문기관	인지
고성군정신건강복지센터	전문기관	인지
김해시정신건강복지센터	전문기관	인지
남해군정신건강복지센터	전문기관	인지
밀양시정신건강복지센터	전문기관	인지
사천시정신건강복지센터	전문기관	인지
산청군정신건강복지센터	전문기관	인지
양산시정신건강복지센터	전문기관	인지
의령군정신건강복지센터	전문기관	인지
진주시정신건강복지센터	전문기관	인지
창녕군정신건강복지센터	전문기관	인지
통영시정신건강복지센터	전문기관	인지
하동군정신건강복지센터	전문기관	인지
함안군정신건강복지센터	전문기관	인지
함양군정신건강복지센터	전문기관	인지
합천군정신건강복지센터	전문기관	인지
경산시정신건강복지센터	전문기관	인지
경주시정신건강복지센터	전문기관	인지
고령군정신건강복지센터	전문기관	인지
구미시정신건강복지센터	전문기관	인지
군위군정신건강복지센터	전문기관	인지
김천시정신건강복지센터	전문기관	인지
문경시정신건강복지센터	전문기관	인지
상주시정신건강복지센터	전문기관	인지
성주군정신건강복지센터	전문기관	인지
안동시정신건강복지센터	전문기관	인지
영덕군정신건강복지센터	전문기관	인지
영양군정신건강복지센터	전문기관	인지
영주시정신건강복지센터	전문기관	인지
영천시정신건강복지센터	전문기관	인지
예천군정신건강복지센터	전문기관	인지
울릉군정신건강복지센터	전문기관	인지
울진군정신건강복지센터	전문기관	인지
의성군정신건강복지센터	전문기관	인지
청도군정신건강복지센터	전문기관	인지
청송군정신건강복지센터	전문기관	인지
칠곡군정신건강복지센터	전문기관	인지
포항시정신건강복지센터	전문기관	인지
광산구정신건강복지센터	전문기관	인지
남구정신건강복지센터	전문기관	인지
동구정신건강복지센터	전문기관	인지
북구정신건강복지센터	전문기관	인지
서구정신건강복지센터	전문기관	인지
남구정신건강복지센터	전문기관	인지
달서구정신건강복지센터	전문기관	인지
달성군정신건강복지센터	전문기관	인지
북구정신건강복지센터	전문기관	인지
서구정신건강복지센터	전문기관	인지
수성구정신건강복지센터	전문기관	인지
중구정신건강복지센터	전문기관	인지
대덕구정신건강복지센터	전문기관	인지
동구정신건강복지센터	전문기관	인지
서구정신건강복지센터	전문기관	인지
유성구정신건강복지센터	전문기관	인지
강서구정신건강복지센터	전문기관	인지
금정구정신건강복지센터	전문기관	인지
기장군정신건강복지센터	전문기관	인지
남구정신건강복지센터	전문기관	인지
동구정신건강복지센터	전문기관	인지
동래구정신건강복지센터	전문기관	인지
부산진구정신건강복지센터	전문기관	인지
북구정신건강복지센터	전문기관	인지
사상구정신건강복지센터	전문기관	인지
사하구정신건강복지센터	전문기관	인지
서구정신건강복지센터	전문기관	인지
수영구정신건강복지센터	전문기관	인지
연제구정신건강복지센터	전문기관	인지
영도구정신건강복지센터	전문기관	인지
중구정신건강복지센터	전문기관	인지
해운대구정신건강복지센터	전문기관	인지
강남구정신건강복지센터	전문기관	인지
강동구정신건강복지센터	전문기관	인지
강북구정신건강복지센터	전문기관	인지
관악구정신건강복지센터	전문기관	인지
구로구정신건강복지센터	전문기관	인지
금천구정신건강복지센터	전문기관	인지
노원구정신건강복지센터	전문기관	인지
도봉구정신건강복지센터	전문기관	인지
서대문구정신건강복지센터	전문기관	인지
서초구정신건강복지센터	전문기관	인지
성동구정신건강복지센터	전문기관	인지
성북구정신건강복지센터	전문기관	인지
양천구정신건강복지센터	전문기관	인지
영등포구정신건강복지센터	전문기관	인지
용산구정신건강복지센터	전문기관	인지
은평구정신건강복지센터	전문기관	인지
중구정신건강복지센터	전문기관	인지
중랑구정신건강복지센터	전문기관	인지
세종시정신건강복지센터	전문기관	인지
남구정신건강복지센터	전문기관	인지
북구정신건강복지센터	전문기관	인지
울주군정신건강복지센터	전문기관	인지
중구정신건강복지센터	전문기관	인지
강화군정신건강복지센터	전문기관	인지
계양구정신건강복지센터	전문기관	인지
남동구정신건강복지센터	전문기관	인지
동구정신건강복지센터	전문기관	인지
미추홀구정신건강복지센터	전문기관	인지
부평구정신건강복지센터	전문기관	인지
서구정신건강복지센터	전문기관	인지
연수구정신건강복지센터	전문기관	인지
중구정신건강복지센터	전문기관	인지
강진군정신건강복지센터	전문기관	인지
고흥군정신건강복지센터	전문기관	인지
곡성군정신건강복지센터	전문기관	인지
광양시정신건강복지센터	전문기관	인지
구례군정신건강복지센터	전문기관	인지
나주시정신건강복지센터	전문기관	인지
담양군정신건강복지센터	전문기관	인지
목포시정신건강복지센터	전문기관	인지
무안군정신건강복지센터	전문기관	인지
보성군정신건강복지센터	전문기관	인지
순천시정신건강복지센터	전문기관	인지
신안군정신건강복지센터	전문기관	인지
여수시정신건강복지센터	전문기관	인지
영광군정신건강복지센터	전문기관	인지
영암군정신건강복지센터	전문기관	인지
완도군정신건강복지센터	전문기관	인지
장성군정신건강복지센터	전문기관	인지
진도군정신건강복지센터	전문기관	인지
함평군정신건강복지센터	전문기관	인지
해남군정신건강복지센터	전문기관	인지
화순군정신건강복지센터	전문기관	인지
고창군정신건강복지센터	전문기관	인지
군산시정신건강복지센터	전문기관	인지
김제시정신건강복지센터	전문기관	인지
남원시정신건강복지센터	전문기관	인지
무주군정신건강복지센터	전문기관	인지
부안군정신건강복지센터	전문기관	인지
순창군정신건강복지센터	전문기관	인지
익산시정신건강복지센터	전문기관	인지
임실군정신건강복지센터	전문기관	인지
장수군정신건강복지센터	전문기관	인지
정읍시정신건강복지센터	전문기관	인지
진안군정신건강복지센터	전문기관	인지
서귀포시정신건강복지센터	전문기관	인지
계룡시정신건강복지센터	전문기관	인지
공주시정신건강복지센터	전문기관	인지
금산군정신건강복지센터	전문기관	인지
논산시정신건강복지센터	전문기관	인지
당진시정신건강복지센터	전문기관	인지
보령시정신건강복지센터	전문기관	인지
부여군정신건강복지센터	전문기관	인지
서산시정신건강복지센터	전문기관	인지
서천군정신건강복지센터	전문기관	인지
아산시정신건강복지센터	전문기관	인지
예산군정신건강복지센터	전문기관	인지
천안시정신건강복지센터	전문기관	인지
청양군정신건강복지센터	전문기관	인지
태안군정신건강복지센터	전문기관	인지
홍성군정신건강복지센터	전문기관	인지
괴산군정신건강복지센터	전문기관	인지
단양군정신건강복지센터	전문기관	인지
보은군정신건강복지센터	전문기관	인지
영동군정신건강복지센터	전문기관	인지
옥천군정신건강복지센터	전문기관	인지
음성군정신건강복지센터	전문기관	인지
제천시정신건강복지센터	전문기관	인지
증평군정신건강복지센터	전문기관	인지
진천군정신건강복지센터	전문기관	인지
충주시정신건강복지센터	전문기관	인지
강릉시중독관리통합지원센터	전문기관	인지
원주시중독관리통합지원센터	전문기관	인지
춘천시중독관리통합지원센터	전문기관	인지
고양시중독관리통합지원센터	전문기관	인지
안산시중독관리통합지원센터	전문기관	인지
안양시중독관리통합지원센터	전문기관	인지
용인시중독관리통합지원센터	전문기관	인지
평택시중독관리통합지원센터	전문기관	인지
화성시중독관리통합지원센터	전문기관	인지
양산시중독관리통합지원센터	전문기관	인지
경산시중독관리통합지원센터	전문기관	인지
포항시중독관리통합지원센터	전문기관	인지
광산구중독관리통합지원센터	전문기관	인지
서구중독관리통합지원센터	전문기관	인지
북구중독관리통합지원센터	전문기관	인지
수성구중독관리통합지원센터	전문기관	인지
중구중독관리통합지원센터	전문기관	인지
동래구중독관리통합지원센터	전문기관	인지
부산진구중독관리통합지원센터	전문기관	인지
사하구중독관리통합지원센터	전문기관	인지
해운대구중독관리통합지원센터	전문기관	인지
강남구중독관리통합지원센터	전문기관	인지
강서구중독관리통합지원센터	전문기관	인지
관악구중독관리통합지원센터	전문기관	인지
노원구중독관리통합지원센터	전문기관	인지
마포구중독관리통합지원센터	전문기관	인지
성북구중독관리통합지원센터	전문기관	인지
송파구중독관리통합지원센터	전문기관	인지
영등포구중독관리통합지원센터	전문기관	인지
종로구중독관리통합지원센터	전문기관	인지
세종시중독관리통합지원센터	전문기관	인지
남구중독관리통합지원센터	전문기관	인지
남동구중독관리통합지원센터	전문기관	인지
부평구중독관리통합지원센터	전문기관	인지
서구중독관리통합지원센터	전문기관	인지
목포시중독관리통합지원센터	전문기관	인지
순천시중독관리통합지원센터	전문기관	인지
여수시중독관리통합지원센터	전문기관	인지
익산시중독관리통합지원센터	전문기관	인지
서귀포시중독관리통합지원센터	전문기관	인지
서산시중독관리통합지원센터	전문기관	인지
천안시중독관리통합지원센터	전문기관	인지
청주시중독관리통합지원센터	전문기관	인지
충주시중독관리통합지원센터	전문기관	인지
가야대학교 간호학과	전공교육	인지
가천대학교 간호/의과/보건/약학학과	전공교육	인지
가톨릭관동대학교 간호학과	전공교육	인지
가톨릭꽃동네대학교 간호학과	전공교육	인지
가톨릭대학교 의과/약학학과	전공교육	인지
가톨릭대학교 간호대학 간호학과	전공교육	인지
가톨릭상지대학교 간호학과	전공교육	인지
강동대학교 간호학과	전공교육	인지
강릉영동대학교 간호학과	전공교육	인지
강릉원주대학교 간호학과	전공교육	인지
강서대학교 간호학과	전공교육	인지
강원대학교 의과/보건/약학학과	전공교육	인지
강원대학교 도계캠퍼스 간호학과	전공교육	인지
강원대학교(춘천) 간호학과	전공교육	인지
건국대학교 간호/의과학과	전공교육	인지
건양대학교 의과/보건학과	전공교육	인지
건양대학교(메디컬) 간호학과	전공교육	인지
경남대학교 간호학과	전공교육	인지
경남정보대학교 간호학과	전공교육	인지
경동대학교 간호학과	전공교육	인지
경민대학교 간호학과	전공교육	인지
경복대학교(남양주) 간호학과	전공교육	인지
경북과학대학교 간호학과	전공교육	인지
경북대학교 간호/의과/보건/약학학과	전공교육	인지
경북보건대학교 간호학과	전공교육	인지
경북전문대학교 간호학과	전공교육	인지
경성대학교 간호/약학학과	전공교육	인지
경운대학교 간호학과	전공교육	인지
경인여자대학교 간호학과	전공교육	인지
경일대학교 간호학과	전공교육	인지
경희대학교 의과/약학학과	전공교육	인지
경희대학교 서울캠퍼스 간호학과	전공교육	인지
계명문화대학교 간호학과	전공교육	인지
고려대학교 간호/의과/보건학과	전공교육	인지
고신대학교 간호/의과학과	전공교육	인지
공주대학교 간호/보건학과	전공교육	인지
광주대학교 간호학과	전공교육	인지
광주보건대학교 간호학과	전공교육	인지
광주여자대학교 간호학과	전공교육	인지
구미대학교 간호학과	전공교육	인지
국군간호사관학교 간호학과	전공교육	인지
국립군산대학교 간호학과	전공교육	인지
국립목포대학교 간호학과	전공교육	인지
국립순천대학교 간호학과	전공교육	인지
국제대학교 간호학과	전공교육	인지
극동대학교 간호학과	전공교육	인지
기독간호대학교 간호학과	전공교육	인지
김천대학교 간호학과	전공교육	인지
나사렛대학교 간호학과	전공교육	인지
남부대학교 간호학과	전공교육	인지
남서울대학교 간호학과	전공교육	인지
단국대학교 의과/보건/약학학과	전공교육	인지
단국대학교 천안캠퍼스 간호학과	전공교육	인지
대경대학교(경산) 간호학과	전공교육	인지
대구가톨릭대학교 간호/약학학과	전공교육	인지
대구과학대학교 간호학과	전공교육	인지
대구대학교 간호학과	전공교육	인지
대구보건대학교 간호학과	전공교육	인지
대동대학교 간호학과	전공교육	인지
대원대학교 간호학과	전공교육	인지
대전과학기술대학교 간호학과	전공교육	인지
대전대학교 간호학과	전공교육	인지
대전보건대학교 간호학과	전공교육	인지
대진대학교 간호학과	전공교육	인지
덕성여자대학교 약학학과	전공교육	인지
동강대학교 간호학과	전공교육	인지
동남보건대학교 간호학과	전공교육	인지
동덕여자대학교 약학학과	전공교육	인지
동명대학교 간호학과	전공교육	인지
동서대학교 간호학과	전공교육	인지
동신대학교 간호학과	전공교육	인지
동아대학교 간호/의과학과	전공교육	인지
동양대학교(영주) 간호학과	전공교육	인지
동의과학대학교 간호학과	전공교육	인지
동의대학교 간호학과	전공교육	인지
두원공과대학교(안성) 간호학과	전공교육	인지
두원공과대학교(파주) 간호학과	전공교육	인지
목포가톨릭대학교 간호학과	전공교육	인지
문경대학교 간호학과	전공교육	인지
배재대학교 간호학과	전공교육	인지
백석대학교 간호학과	전공교육	인지
백석문화대학교 간호학과	전공교육	인지
부경대학교 간호학과	전공교육	인지
부산가톨릭대학교 간호학과	전공교육	인지
부산과학기술대학교 간호학과	전공교육	인지
부산대학교 간호/의과/보건/약학학과	전공교육	인지
부산보건대학교 간호학과	전공교육	인지
부산여자대학교 간호학과	전공교육	인지
부천대학교(소사) 간호학과	전공교육	인지
삼육대학교 간호/보건/약학학과	전공교육	인지
삼육보건대학교 간호학과	전공교육	인지
상명대학교 간호학과	전공교육	인지
상지대학교 간호학과	전공교육	인지
서영대학교(광주) 간호학과	전공교육	인지
서영대학교(파주) 간호학과	전공교육	인지
서울대학교 간호/의과/보건/약학학과	전공교육	인지
서울여자간호대학교 간호학과	전공교육	인지
서일대학교 간호학과	전공교육	인지
서정대학교 간호학과	전공교육	인지
선린대학교 간호학과	전공교육	인지
선문대학교 간호학과	전공교육	인지
성균관대학교 의과/약학학과	전공교육	인지
성신여자대학교 간호학과	전공교육	인지
세경대학교 간호학과	전공교육	인지
세명대학교 간호학과	전공교육	인지
세한대학교 영암캠퍼스 간호학과	전공교육	인지
송곡대학교 간호학과	전공교육	인지
송원대학교 간호학과	전공교육	인지
송호대학교 간호학과	전공교육	인지
수성대학교 간호학과	전공교육	인지
수원과학대학교 간호학과	전공교육	인지
수원대학교 간호학과	전공교육	인지
수원여자대학교 간호학과	전공교육	인지
숙명여자대학교 약학학과	전공교육	인지
순천대학교 약학학과	전공교육	인지
신라대학교 간호/보건학과	전공교육	인지
신성대학교 간호학과	전공교육	인지
신한대학교(동두천) 간호학과	전공교육	인지
아주대학교 간호/의과/보건/약학학과	전공교육	인지
안동대학교 간호학과	전공교육	인지
안산대학교 간호학과	전공교육	인지
여주대학교 간호학과	전공교육	인지
연성대학교 간호학과	전공교육	인지
연세대학교 의과/보건/약학학과	전공교육	인지
연세대학교 미래캠퍼스 간호학과	전공교육	인지
연세대학교(신촌) 간호학과	전공교육	인지
연세대학교(원주) 의과/보건학과	전공교육	인지
영남대학교 의과/약학학과	전공교육	인지
영남이공대학교 간호학과	전공교육	인지
영산대학교 간호학과	전공교육	인지
영진전문대학교(복현) 간호학과	전공교육	인지
예수대학교 간호학과	전공교육	인지
용인예술과학대학교 간호학과	전공교육	인지
우석대학교 간호학과	전공교육	인지
우송대학교 간호학과	전공교육	인지
우송정보대학 간호학과	전공교육	인지
울산과학대학교 간호학과	전공교육	인지
울산대학교 간호학과	전공교육	인지
울산대학교(서울아산병원) 의과학과	전공교육	인지
원광대학교 간호/의과/보건/약학학과	전공교육	인지
위덕대학교 간호학과	전공교육	인지
유원대학교 간호학과	전공교육	인지
을지대학교 보건학과	전공교육	인지
을지대학교 성남캠퍼스 간호학과	전공교육	인지
을지대학교 의정부캠퍼스 간호학과	전공교육	인지
인제대학교 간호/의과/보건/약학학과	전공교육	인지
인천가톨릭대학교 간호학과	전공교육	인지
인하대학교 간호/의과학과	전공교육	인지
재능대학교 간호학과	전공교육	인지
전남대학교 간호/의과/보건/약학학과	전공교육	인지
제주대학교 간호/의과/보건/약학학과	전공교육	인지
조선간호대학교 간호학과	전공교육	인지
조선대학교 간호/의과/약학학과	전공교육	인지
중부대학교 간호학과	전공교육	인지
중앙대학교 의과/약학학과	전공교육	인지
중앙대학교 적십자간호대학 간호학과	전공교육	인지
중원대학교(괴산) 간호학과	전공교육	인지
차의과학대학교 간호/의과/약학학과	전공교육	인지
창신대학교 간호학과	전공교육	인지
창원대학교 간호학과	전공교육	인지
청운대학교 홍성캠퍼스 간호학과	전공교육	인지
청주대학교 간호학과	전공교육	인지
초당대학교 간호학과	전공교육	인지
춘해보건대학교 간호학과	전공교육	인지
충남대학교 간호/의과/보건/약학학과	전공교육	인지
충북대학교 간호/의과/약학학과	전공교육	인지
충북보건과학대학교 간호학과	전공교육	인지
충청대학교 간호학과	전공교육	인지
한국교통대학교 증평캠퍼스 간호학과	전공교육	인지
한국성서대학교 간호학과	전공교육	인지
한남대학교 간호학과	전공교육	인지
한림대학교 간호/의과학과	전공교육	인지
한림성심대학교 간호학과	전공교육	인지
한서대학교 간호학과	전공교육	인지
한세대학교 간호학과	전공교육	인지
한일장신대학교 간호학과	전공교육	인지
혜전대학교 간호학과	전공교육	인지
호남대학교 간호학과	전공교육	인지
호서대학교 간호학과	전공교육	인지
호원대학교 간호학과	전공교육	인지
화성의과학대학교 간호학과	전공교육	인지
